F 62,32,14
C 22,70,91

NO XPM/Prison.XPM
SO XPM/Prison.XPM
WE XPM/Prison.XPM
EA XPM/Prison.XPM


1111111111111111111111111111111111111111111111
1000000000111111111110000111111111111000001111
1001110001111111111111101111111111111111101111
1011111111111111111111101111111111111111101111
1011111111011111111000101111111111111111101111
1011111111011111111000101111111111111111101111
1000000000010000000000000000000000000000001111
1000000000111111111111111111111111111111101111
1111111110111111111111111111111111111111101111
1111111110111111111111111111111111111111101111
1111111110111111111111111111111111111111101111
1111111110111111111111111111111111111111101111
1111111110111111111111111111111111111111101111
1000000000000000000000000000000000000000000001
1000000000000000000000000000000000000000000001
1000000000000000000000N00000000000000000000001
1111111111111111111111111111111111111111111111