NO XPM/Wall.XPM
SO XPM/Chen-Exit.XPM
WE XPM/Mur.XPM
EA XPM/Snake.XPM


F 249,22,12
C 1,20,249





  1111111   1111111
 1100000111110000011
 1000N00000000000001
 1100000111110000011
  1111111   1111111















































